XXXXXXXXXXXXXXXXX
XX             XX
XX  XXXXXXXXX  XX
XX             XX
XXXXXXXXXXXXXXXXX