XXXXXXXXXXXXXXXX
X     XX       X
X  XX     XX   X
X  XX     XX   X
X     XX       X
XXXXXXXXXXXXXXXX