XXXXXXXXXXXXXXXX
XX            XX
XX  XXXXXXXX  XX
XX  XX    XX  XX
XX  XX    XX  XX
XX  XXXXXXXX  XX
XX            XX
XXXXXXXXXXXXXXXX